Complete Photoshop tutorial from beginner to pro	/course/photoshop-masterclass-from-beginners-to-pro/
Pivot Tables Playground for Business Users	/course/pivot-tables-playground-for-business-users/
Amazon Web Services (AWS) 101	/course/amazon-web-services-101/
Business Writing - How You Can Become a Great Writer	/course/business-writing-how-you-can-become-a-great-writer/
Teens: Reduce Stress Using Mindfulness & Become a Superstar	/course/becoming-a-superstar-by-learning-our-simple-method/
Java OOP Basics	/course/java-oop-basics/
Workplace Neuroscience: Decoding your brain at work	/course/workplace-neuroscience-decoding-your-brain-at-work/
Advanced VBA - Files and Folder Management	/course/advanced-vba-files-and-folder-management/
Marketing Cloud Email Specialist Study Guide & Sample Tests	/course/marketing-cloud-email-specialist-study-guide-sample-tests/
Pipe Modeling and Marking with ISOtracer	/course/pipe-modeling-and-marking-with-isotracer/
Linear Circuits 1 - 08 - Resistor Networks	/course/linear-circuits-1-08-resistor-networks/
How to use MIT App Inventor 2 course	/course/how-to-use-mit-app-inventor-2-course/
Mailchimp Masterclass - Learn Customer Journeys	/course/mailchimp-customer-journeys-class/
CBSE Class 12 Biology - Reproduction (Chapters 1 to 3)	/course/cbse-class-12-biology-reproduction-chapters-1-to-3/
Create a GUI with Python	/course/create-a-gui-with-python-pysimplegui/
Linear Circuits 1 - 10 - Voltage & Current Division, Part 1	/course/linear-circuits-1-10-voltage-current-division-part-1/
Matlab Basics for Mechanical engineers	/course/matlab-basics-for-mechanical-engineers/
We ArtPlay Piano	/course/we-artplay-piano/
Canva para Principiantes	/course/canva-para-principiantes/
Gandhian Methods to Sustainable Living and Happiness	/course/gandhian-methods-to-sustainable-living-and-happiness/
Get Your S**t Together and Love Yourself	/course/get-your-st-together-and-love-yourself/
Side Effects of Crystal Healing	/course/side-effects-of-crystal-healing/
Create Your Best Life	/course/create-your-best-life/
Procrastination Killer	/course/procrastination-killer/
Advanced class : What is the 1 thing to do after any course?	/course/free-advanced-class-what-1-thing-to-do-after-any-course/
How can your hotel optimise Booking and Expedia during Covid	/course/how-can-your-hotel-optimise-booking-and-expedia-during-covid/
How to make a professional Tshirt design masterclass	/course/how-to-make-a-professional-tshirt-design-masterclass/
Learn finger painting on your phone with the Paintology app	/course/learn-finger-painting-on-your-phone-with-the-paintology-app/
Home Business Freelancing Online. Freelancing Home Business	/course/profitable-home-based-business-earn-money-online-for-newbies/
Create a 3D character in Blender from scratch	/course/create-a-3d-character-in-blender/
Create Ability Effect In Unreal Engine - Summoner Part	/course/create-ability-effect-in-unreal-engine-summoner-part/
Learn basics about A.I. (Artificial Intelligence)	/course/learn-basics-of-artificial-intelligence/
My Real Market Trading Journal	/course/my-real-market-trading-journal/
Basics of Procurement	/course/basics-of-procurement/
Getting Started with Romeo and Juliet	/course/romeo-and-juliet-getting-started/
Maths Made Easy for Adult Learners	/course/maths-made-easy-for-adult-learners/
Me and Time: Relationship Management 4 Success	/course/me-and-time-relationship-management-4-success/
Draw a portrait of Ellen DeGeneres with the Paintology app	/course/draw-a-portrait-of-ellen-degeneres-with-the-paintology-app/
Build A Clothing Store With WordPress & WooCommerce in 2hrs	/course/build-an-ecommerce-store-with-wordpress-in-2hours/
Introductory Cosmology	/course/introductory-cosmology/
